523,523,523,422,429,460,461,592,130,130,130,130,130,130,130,130,130,130,130,130,130,130,332,333,130,
523,458,618,618,460,460,528,130,130,130,130,130,130,130,130,130,130,130,130,130,130,162,162,366,367,
523,426,460,429,460,460,592,130,130,881,881,130,130,130,130,130,130,881,130,130,130,162,162,331,130,
458,618,429,460,460,496,130,130,130,817,130,130,130,426,130,130,130,784,817,130,130,130,130,130,130,
426,429,460,460,460,592,130,130,130,130,130,130,591,424,497,130,130,130,881,130,130,130,130,130,130,
426,460,429,461,560,130,130,130,130,130,655,524,523,424,429,497,130,130,130,130,130,881,817,130,424,
456,429,461,592,130,130,130,130,130,591,523,523,523,424,492,465,130,130,130,130,130,130,130,559,424,
458,461,592,130,130,130,130,130,655,523,523,523,523,424,429,492,561,130,130,130,899,130,493,523,424,
618,464,593,130,881,881,130,749,524,523,523,523,424,429,429,429,560,130,130,130,130,130,462,523,424,
460,496,130,720,130,130,130,495,524,523,587,424,429,492,428,528,130,130,720,130,130,130,462,523,424,
460,528,130,130,130,130,130,689,524,523,587,424,429,428,461,592,130,130,130,130,130,591,525,523,424,
460,464,130,805,130,130,130,130,495,523,523,491,460,461,528,130,130,130,130,130,591,525,523,523,424,
460,560,130,130,130,130,130,130,689,523,523,524,491,657,130,130,130,130,493,525,525,523,523,424,717,
528,130,130,130,130,881,130,130,130,651,524,524,524,592,130,881,130,130,462,524,524,523,523,424,460,
528,130,130,130,881,881,130,130,130,130,651,682,681,130,130,784,130,130,462,524,523,523,523,491,428,
528,130,130,130,130,130,130,130,130,557,744,130,130,130,130,130,130,130,462,523,523,523,424,717,428,
528,130,881,130,130,130,130,130,557,776,130,130,932,130,130,130,130,493,555,523,523,491,717,428,428,
528,130,817,130,130,130,130,591,424,593,130,130,130,130,130,130,493,524,523,523,424,717,428,428,428,
528,130,130,130,130,130,591,424,460,497,720,130,130,130,130,493,524,523,523,523,424,460,428,428,428,
465,100,130,130,130,591,524,424,429,460,497,130,130,130,493,524,523,523,523,523,424,429,428,428,428,
429,529,100,130,130,495,524,459,429,460,496,130,881,130,493,524,523,523,523,523,424,429,428,428,428,
492,496,100,130,130,495,524,491,460,429,528,881,881,130,493,524,523,523,523,523,424,429,428,428,428,
460,496,130,932,130,559,524,459,461,461,592,130,130,130,130,493,524,523,523,523,456,717,432,494,461,
429,592,130,130,130,130,559,651,560,130,130,130,130,130,130,130,559,524,524,524,522,461,713,130,130,
592,130,130,130,130,130,130,130,130,130,130,130,720,130,130,130,130,622,622,713,522,651,130,130,720,
130,130,130,130,130,880,881,130,130,130,130,130,130,130,130,130,130,130,130,130,807,808,809,130,130,
130,130,130,130,130,130,849,130,130,130,130,130,130,130,130,130,881,130,130,130,839,840,841,130,130,
130,817,881,881,130,130,130,130,130,130,130,130,130,130,130,130,784,130,130,130,871,872,873,130,130,
881,721,754,787,881,130,130,931,130,130,720,881,881,814,130,130,130,130,130,130,130,330,130,130,817,
721,754,754,754,787,881,130,130,130,721,787,787,881,946,130,130,130,130,932,130,357,399,130,784,849